NO ./texture/north_tex.xpm
SO ./texture/south_tex.xpm
WE ./texture/west_tex.xpm
EA ./texture/east_tex.xpm

C 92,148,252
F 200,76,12

     1      
11111011    
10000W001   
11111011    
1111101     
1111101     
1111101     
1111101     
1111101     
1111101     
1111101     
1111101     
1111101     
1111101     
1111101     
1111101     
1111101     
1111101     
1111101     
1111101     
1111101     
1111101     
1111101     
1111101     
1111101     
1111101     
1111101     
1111101     
1111101     
1111101     
1111101     
1111101     
1111101     
1111101     
1111101     
1111101     
1111101     
1111101     
1111101     
1111101     
1111101     
1111101     
1111101     
1111101     
1111101     
1111101     
1111101     
1111101     
1111101     
1111101     
1111101     
1111101     
1111101     
1111101     
1111101     
1111101     
1111101     
1111101     
1111101     
1111101     
1111101     
1111101     
1111101     
1111101     
1111101     
1111101     
1111101     
1111101     
1111101     
1111101     
1111101     
1111101     
1111101     
1111101     
1111101     
1111101     
1111101     
1111101     
1111101     
1111101     
1111101     
1111101     
1111101     
1111101     
1111101     
1111101     
1111101     
1111101     
1111101     
1111101     
1111101     
1111101     
1111101     
1111101     
1111101     
1111101     
1111101     
1111101     
1111101     
1111101     
1111101     
1111101     
1111101     
1111101     
1111101     
1111101     
1111101     
1111101     
1111101     
1111101     
1111101     
1111101     
1111101     
1111101     
1111101     
1111101     
1111101     
1111101     
1111101     
1111101     
1111101     
1111101     
1111101     
1111101     
1111101     
1111101     
1111101     
1111101     
1111101     
1111101     
1111101     
1111101     
1111101     
1111101     
1111101     
1111101     
1111101     
1111101     
1111101     
1111101     
1111101     
1111101     
1111101     
1111101     
1111101     
1111101     
1111101     
1111101     
1111101     
1111101     
1111101     
1111101     
1111101     
1111101     
1111101     
1111101     
1111101     
1111101     
1111101     
1111101     
1111101     
1111101     
1111101     
1111101     
1111101     
1111101     
1111101     
1111101     
1111101     
1111101     
1111101     
1111101     
1111101     
1111101     
1111101     
1111101     
1111101     
1111101     
1111101     
1111101     
1111101     
1111101     
1111101     
1111101     
1111101     
1111101     
1111101     
1111101     
1111101     
1111101     
1111101     
1111101     
1111101     
1111101     
1111101     
1111101     
1111101     
111111      
