NO ./texture/north_tex.xpm
SO ./texture/south_tex.xpm
WE ./texture/west_tex.xpm
EA ./texture/east_tex.xpm

C 0,70,255
F 200,76,12

111111111111                  111 
100000000001                  101     
100000000111111111111111111111101
101000000000000000000000000000001
10000N0000000000000000000000000001          11111
1000000000011111111111111111000001          10001
100000000001               1000001          11101
111111111111               1000001             1  
                           1111111 
